19 19 19 19 19 19 19 19 19 19 19 19 19 19 19 19 19 19 19 19 19 19 19 19 19 19 19 19 19 19 19 19 19 19 19 19 19 19 19 19 19 19 19 19 19 19 19 19 19 19 
19 19 19 19 19 19 19 19 19 19 19 19 19 19 19 19 19 19 19 19 19 19 19 19 19 19 19 19 19 19 19 19 19 19 19 19 19 19 19 19 19 19 19 19 19 19 19 19 19 19 
19 19 19 19 19 19 19 19 19 19 19 19 19 19 19 19 19 19 19 19 19 19 19 19 19 19 19 19 19 19 19 19 19 19 19 19 19 19 19 19 19 19 19 19 19 19 19 19 19 19 
19 19 19 19 19 19 19 19 19 19 19 19 19 19 19 19 19 19 19 19 19 19 19 19 19 19 19 19 19 19 19 19 19 19 19 19 19 19 19 19 19 19 19 19 19 19 19 19 19 19 
19 19 19 19 19 19 19 19 19 19 19 19 19 19 19 19 19 19 19 19 19 19 19 19 19 19 19 19 19 19 19 19 19 19 19 19 19 19 19 19 19 19 19 19 19 19 19 19 19 19 
19 19 19 19 19 19 19 19 19 19 19 19 19 19 19 19 19 19 19 19 19 19 19 19 19 19 19 19 19 19 19 19 19 19 19 19 19 19 19 19 19 19 19 19 19 19 19 19 19 19 
19 19 19 19 19 19 19 19 19 19 19 19 19 19 19 19 19 19 19 19 19 19 19 19 19 19 19 19 19 19 19 19 19 19 19 19 19 19 19 19 19 19 19 19 19 19 19 19 19 19 
19 19 19 19 19 19 19 19 19 19 19 19 19 19 19 19 19 19 19 19 19 19 19 34 34 34 34 34 34 19 19 19 19 19 19 19 19 19 19 19 19 19 19 19 19 19 19 19 19 19 
19 19 19 19 19 19 19 19 19 19 19 19 19 19 19 19 19 19 19 19 19 19 19 34 34 34 34 34 34 34 34 19 19 19 19 19 19 19 19 19 19 19 19 19 19 19 19 19 19 19 
19 19 19 19 19 19 19 19 19 19 19 19 19 19 19 19 34 34 34 34 19 19 19 19 19 19 19 19 34 34 34 34 19 19 19 19 19 19 19 19 19 19 19 19 19 19 19 19 19 19 
19 19 19 19 19 19 19 19 19 19 19 19 19 19 34 34 34 19 34 34 34 34 34 34 34 34 34 19 19 19 34 34 34 19 19 19 19 19 19 19 19 19 19 19 19 19 19 19 19 19 
19 19 19 19 19 19 19 19 19 19 19 19 34 34 34 34 34 34 34 34 34 34 34 34 34 34 34 34 19 19 19 34 34 19 19 19 19 19 19 19 19 19 19 19 19 19 19 19 19 19 
19 19 19 19 19 19 19 19 19 19 19 19 34 34 34 34 34 34 19 34 34 34 34 34 34 19 34 34 34 34 34 34 34 34 19 19 19 19 19 19 19 19 19 19 19 19 19 19 19 19 
19 19 19 19 19 19 19 19 19 19 19 19 19 19 19 19 34 34 34 34 34 34 34 34 34 34 34 34 34 34 34 34 34 34 34 34 34 34 19 19 19 19 19 19 19 19 19 19 19 19 
19 19 19 19 19 19 19 19 19 19 19 19 19 19 19 19 34 34 34 34 34 34 34 34 34 34 34 34 34 19 19 19 19 34 34 34 34 34 34 34 19 19 19 19 19 19 19 19 19 19 
19 19 19 19 19 19 19 19 19 19 19 19 34 34 34 19 34 34 34 34 34 34 34 34 34 34 34 34 34 34 19 19 19 19 19 34 19 34 34 34 19 19 19 19 19 19 19 19 19 19 
19 19 19 19 19 19 19 19 19 19 19 34 34 34 34 34 34 34 19 34 34 34 34 19 34 34 34 34 19 34 19 19 19 19 19 19 19 19 34 34 34 19 19 19 19 19 19 19 19 19 
19 19 19 19 19 19 19 19 19 19 19 19 34 34 34 19 34 34 34 34 34 34 34 34 34 34 34 34 34 34 19 19 19 19 19 19 19 19 19 34 34 19 19 19 19 19 19 19 19 19 
19 19 19 19 19 19 19 19 19 19 19 19 19 19 19 19 34 34 34 34 34 34 34 34 34 34 34 34 34 34 34 34 19 19 19 19 19 19 19 34 34 19 19 19 19 19 19 19 19 19 
19 19 19 19 19 19 19 19 19 19 19 19 19 19 19 19 34 34 34 34 34 34 34 34 34 34 34 34 34 34 34 19 19 19 19 19 19 19 19 34 34 34 19 19 19 19 19 19 19 19 
19 19 19 19 19 19 19 19 19 19 19 19 19 34 34 34 34 34 34 34 34 34 34 34 34 34 34 34 34 34 34 34 34 19 19 19 19 19 19 34 34 34 34 34 19 19 19 19 19 19 
19 19 19 19 19 19 19 19 19 19 19 19 19 34 34 34 19 34 34 34 34 34 34 34 34 34 34 34 34 34 34 34 34 34 19 19 19 19 19 19 34 34 34 34 34 19 19 19 19 19 
19 19 19 19 19 19 19 19 19 19 19 19 19 19 19 34 34 34 34 34 19 34 34 34 34 34 34 34 34 34 34 34 34 34 19 19 19 19 19 19 19 19 34 34 34 19 19 19 19 19 
19 19 19 19 19 19 19 19 19 19 19 19 19 19 19 19 19 19 19 19 19 19 19 19 19 19 19 34 34 34 34 34 34 34 34 34 19 19 19 19 19 19 19 19 19 19 19 19 19 19 
19 19 19 19 19 19 19 19 19 19 19 19 19 19 19 19 19 19 19 19 19 19 19 19 19 19 19 19 19 34 34 34 34 34 34 34 19 19 19 19 19 19 19 19 19 19 19 19 19 19 
19 19 19 19 19 19 19 19 19 19 19 19 19 19 19 19 19 19 19 19 19 19 19 19 19 19 19 19 19 19 19 19 34 34 34 34 34 19 19 19 19 19 19 19 19 19 19 19 19 19 
19 19 19 19 19 19 19 19 19 19 19 19 19 19 19 19 19 19 19 19 19 19 19 19 19 19 19 19 19 19 19 19 19 34 34 34 34 34 19 19 19 34 34 19 19 19 19 19 19 19 
19 19 19 19 19 19 19 19 19 19 19 19 19 19 19 34 34 19 34 19 19 19 19 19 19 19 19 19 19 19 19 19 19 19 34 34 34 34 19 19 19 19 19 34 19 19 19 19 19 19 
19 19 19 19 19 19 19 19 19 19 19 19 34 34 34 34 34 34 34 34 34 34 34 19 19 19 19 19 19 19 19 19 19 19 19 34 34 34 34 19 19 19 19 19 19 19 19 19 19 19 
19 19 19 19 19 19 19 19 19 19 19 19 34 34 34 34 34 34 34 34 34 34 19 34 34 34 19 19 19 19 19 19 19 19 19 34 34 34 34 19 19 19 19 19 19 19 19 19 19 19 
19 19 19 19 19 19 19 19 19 19 19 34 34 34 34 19 34 34 34 34 34 34 34 34 34 34 19 19 19 19 19 19 19 19 19 34 34 34 19 19 19 19 19 19 19 19 19 19 19 19 
19 19 19 19 19 19 19 19 19 19 34 34 34 34 34 34 34 34 34 34 34 34 34 19 34 34 34 34 34 34 34 34 34 34 34 34 34 34 19 19 19 19 19 19 19 19 19 19 19 19 
19 19 19 19 19 19 19 19 19 19 34 34 34 34 34 34 34 34 34 19 34 34 34 34 34 34 34 34 34 34 34 34 34 34 34 34 34 34 19 19 19 19 19 19 19 19 19 19 19 19 
19 19 19 19 19 19 19 19 19 34 34 34 34 34 34 34 34 34 34 34 34 34 34 34 34 34 34 34 34 34 34 34 34 34 34 34 34 19 19 19 19 19 19 19 19 19 19 19 19 19 
19 19 19 19 19 19 19 19 19 34 34 34 34 34 34 34 34 34 34 34 34 34 19 34 34 19 34 34 19 19 19 19 19 34 34 19 19 19 19 19 19 19 19 19 19 19 19 19 19 19 
19 19 19 19 19 19 19 34 19 34 34 19 34 34 34 19 34 34 34 34 34 34 34 19 34 34 34 19 19 19 19 19 19 34 34 34 19 19 19 19 19 19 19 19 19 19 19 19 19 19 
19 19 19 19 19 19 19 19 19 34 34 34 34 34 34 34 34 34 34 34 34 34 34 34 34 34 19 19 19 19 19 19 19 34 34 34 34 19 19 19 19 19 19 19 19 19 19 19 19 19 
19 19 19 19 19 19 19 19 19 19 34 34 34 34 34 34 34 34 34 34 34 34 34 34 34 34 19 19 19 34 34 19 19 19 34 34 34 19 19 19 19 19 19 19 19 19 19 19 19 19 
19 19 19 19 19 19 19 19 19 19 19 34 34 34 34 34 34 34 34 34 34 34 19 34 34 19 19 19 19 19 19 19 19 19 34 34 34 19 19 19 19 19 19 19 19 19 19 19 19 19 
19 19 19 19 19 19 19 19 19 19 19 19 34 19 34 34 34 34 34 34 34 34 34 34 19 19 19 19 19 19 19 19 19 19 19 34 34 19 19 19 19 19 19 19 19 19 19 19 19 19 
19 19 19 19 19 19 19 19 19 19 19 19 19 34 34 34 19 19 34 19 34 34 19 34 19 19 19 19 19 19 19 19 19 19 19 19 34 19 19 19 19 19 19 19 19 19 19 19 19 19 
19 19 19 19 19 19 19 19 19 19 19 19 19 19 34 34 34 34 19 19 19 19 19 19 19 19 19 19 19 19 19 19 19 19 19 19 19 19 19 19 19 19 19 19 19 19 19 19 19 19 
19 19 19 19 19 19 19 19 19 19 19 19 19 19 19 19 19 19 19 19 19 19 19 19 19 19 19 19 19 19 19 19 19 19 19 19 19 19 19 19 19 19 19 19 19 19 19 19 19 19 
19 19 19 19 19 19 19 19 19 19 19 19 19 19 19 19 19 19 19 19 34 34 19 19 19 19 19 19 19 19 19 19 19 19 19 19 19 19 19 19 19 19 19 19 19 19 19 19 19 19 
19 19 19 19 19 19 19 19 19 19 19 19 19 19 19 19 19 19 19 19 19 19 19 19 19 19 19 19 19 19 19 19 19 19 19 19 19 19 19 19 19 19 19 19 19 19 19 19 19 19 
19 19 19 19 19 19 19 19 19 19 19 19 19 19 19 19 19 19 19 19 19 19 19 19 19 19 19 19 19 19 19 19 19 19 19 19 19 19 19 19 19 19 19 19 19 19 19 19 19 19 
19 19 19 19 19 19 19 19 19 19 19 19 19 19 19 19 19 19 19 19 19 19 19 19 19 19 19 19 19 19 19 19 19 19 19 19 19 19 19 19 19 19 19 19 19 19 19 19 19 19 
19 19 19 19 19 19 19 19 19 19 19 19 19 19 19 19 19 19 19 19 19 19 19 19 19 19 19 19 19 19 19 19 19 19 19 19 19 19 19 19 19 19 19 19 19 19 19 19 19 19 
19 19 19 19 19 19 19 19 19 19 19 19 19 19 19 19 19 19 19 19 19 19 19 19 19 19 19 19 19 19 19 19 19 19 19 19 19 19 19 19 19 19 19 19 19 19 19 19 19 19 
19 19 19 19 19 19 19 19 19 19 19 19 19 19 19 19 19 19 19 19 19 19 19 19 19 19 19 19 19 19 19 19 19 19 19 19 19 19 19 19 19 19 19 19 19 19 19 19 19 19 
