3 3 3 3 3 3 3 3 3 3 3 3 3 3 3 3
3 4 4 4 0 0 0 0 0 0 0 0 0 0 4 3
3 4 4 4 0 0 0 0 0 0 0 0 0 0 0 1
3 4 4 0 0 0 0 0 0 0 0 0 0 0 1 1
3 0 0 0 0 0 0 0 0 0 0 0 0 0 1 2
3 0 0 0 0 0 0 0 0 0 0 0 0 1 2 2
2 1 4 0 0 0 0 0 0 0 0 0 4 1 2 2
2 2 1 4 0 0 0 0 0 0 0 0 1 2 2 2
2 2 2 1 4 0 0 0 0 0 0 1 2 2 2 2
2 2 2 2 1 0 0 0 0 0 1 2 2 2 2 2
2 2 2 2 2 1 4 4 4 1 2 2 2 2 2 2
2 2 2 2 2 2 1 4 1 2 2 2 2 2 2 2

