19 19 19 19 19 19 19 19 19 19 19 19 19 19 19 19 19 19 19 19 19 19 19 19 19 19 19 19 19 19 19 19 19 19 19 19 19 19 19 19 19 19 19 19 19 19 19 19 19 19 
19 18 18 18 18 18 18 18 18 18 18 18 18 18 18 18 18 18 18 18 18 18 18 18 18 18 18 18 18 18 18 18 18 18 18 18 18 18 18 18 18 18 18 18 18 18 18 18 18 19 
19 18 18 18 18 18 18 18 18 18 18 18 18 18 18 18 18 18 18 18 18 18 18 18 18 18 18 18 18 18 18 18 18 18 18 18 18 18 18 18 18 18 18 18 18 18 18 18 18 19 
19 18 18 18 18 18 18 18 18 18 18 18 18 18 18 18 18 18 18 18 18 18 18 18 18 18 18 18 18 18 18 18 18 18 18 18 18 18 18 18 18 18 18 18 18 18 18 18 18 19 
19 18 18 18 18 18 18 18 18 18 18 18 18 18 18 18 18 18 18 18 18 18 18 22 23 23 23 23 23 23 23 23 23 23 23 24 18 18 18 18 18 18 18 18 18 18 18 18 18 19 
19 18 18 18 18 18 18 18 18 18 18 2 2 18 18 18 18 18 18 18 18 18 18 25 21 20 20 20 20 20 21 20 21 21 20 26 18 18 18 18 18 18 18 18 18 18 18 18 18 19 
19 18 18 18 18 18 18 18 18 18 18 18 18 18 2 18 18 18 18 18 18 18 18 25 20 20 20 21 20 20 20 20 20 20 20 26 18 18 18 18 18 18 18 18 18 18 18 18 18 19 
19 18 18 18 18 18 18 18 18 18 18 18 18 18 18 18 18 18 18 18 18 18 18 25 20 20 2 1 2 2 1 2 1 2 20 26 18 18 18 18 18 18 18 18 18 18 18 18 18 19 
19 18 18 18 18 18 18 2 18 18 18 18 18 18 18 18 18 18 18 2 2 18 18 25 20 21 1 18 18 1 1 18 18 1 20 26 18 18 18 18 18 18 18 18 18 18 18 18 18 19 
19 18 18 18 18 18 2 18 18 18 18 18 18 18 18 18 18 18 18 18 18 18 22 33 20 20 1 18 18 1 1 18 18 2 21 26 18 18 18 18 18 18 18 18 18 18 18 18 18 19 
19 18 18 18 18 18 18 18 18 18 18 18 18 1 18 18 18 18 18 18 18 18 25 21 20 20 2 2 1 0 0 2 1 1 20 26 18 18 18 18 18 2 1 18 18 18 18 18 18 19 
19 18 18 18 18 18 18 18 18 18 18 18 2 1 1 18 18 2 2 18 18 18 25 20 20 20 20 20 20 0 0 20 20 20 21 26 18 18 18 18 18 1 4 18 18 18 18 18 18 19 
19 18 18 18 18 18 18 18 18 18 18 18 2 18 1 18 1 2 2 18 18 18 25 20 21 20 21 20 20 0 0 21 20 21 21 26 18 18 4 4 1 4 2 18 18 18 18 18 18 19 
19 18 18 18 18 18 18 2 18 18 18 18 2 2 2 2 2 2 2 18 18 18 27 28 28 28 28 28 20 0 0 28 28 28 28 29 18 18 2 18 18 18 18 18 18 18 18 18 18 19 
19 18 18 18 18 18 18 2 18 18 18 1 1 2 2 18 1 2 2 2 18 18 18 18 18 18 18 18 18 4 4 18 18 18 18 18 18 18 1 18 18 18 18 18 18 18 18 18 18 19 
19 18 18 18 18 18 18 18 18 18 18 18 1 18 2 1 1 2 18 1 18 18 18 18 18 18 18 18 18 2 2 18 18 18 18 18 18 18 2 18 18 18 18 18 18 18 18 18 18 19 
19 18 18 18 18 18 18 18 18 18 18 18 18 1 2 2 1 1 1 1 18 18 18 18 18 18 18 18 18 4 2 18 18 18 18 18 1 2 2 18 18 18 18 18 18 18 18 18 18 19 
19 18 18 18 18 18 18 18 18 18 18 18 18 18 1 2 2 2 2 2 18 18 18 18 18 18 18 18 18 4 2 18 18 18 18 18 1 18 18 18 18 18 18 18 18 18 18 18 18 19 
19 18 18 18 18 18 18 18 18 18 18 18 18 18 1 1 2 2 2 2 2 2 18 18 18 18 18 18 18 4 4 18 18 18 18 18 1 18 18 18 18 18 18 18 18 18 18 18 18 19 
19 18 18 18 18 18 18 18 18 18 18 18 18 18 1 1 1 18 1 1 2 2 18 18 18 18 18 18 18 2 2 18 18 18 18 18 1 18 2 18 18 18 18 18 18 18 18 18 18 19 
19 18 18 18 18 18 18 18 18 18 18 18 1 18 4 2 4 4 4 2 4 18 4 4 4 18 18 18 18 4 4 18 18 18 18 18 2 2 2 2 18 18 18 18 18 18 18 18 18 19 
19 18 18 18 18 18 18 18 18 18 18 18 4 4 4 4 4 4 4 4 4 4 4 2 4 18 18 18 18 2 4 18 18 18 18 2 18 2 2 2 18 18 18 18 18 18 18 18 18 19 
19 18 18 18 18 18 18 18 18 18 18 18 4 2 18 18 18 18 18 18 18 18 18 2 4 4 4 4 4 4 2 18 18 18 18 2 2 2 2 2 18 18 18 18 18 18 18 18 18 19 
19 18 18 18 18 18 18 18 18 18 18 18 4 4 18 18 18 18 18 18 18 18 18 18 4 2 4 2 2 4 2 1 4 2 2 4 1 1 1 1 18 18 18 18 18 18 18 18 18 19 
19 18 18 18 18 18 18 18 18 18 18 18 18 4 18 18 18 18 18 18 18 18 18 18 18 18 18 18 1 18 18 18 18 18 18 18 18 18 18 1 18 18 18 18 18 18 18 18 18 19 
19 18 18 18 18 18 18 18 18 18 18 18 18 4 18 18 18 18 18 18 18 18 18 18 18 18 18 18 18 18 18 18 18 18 18 18 18 18 18 1 18 18 18 18 18 18 18 18 18 19 
19 18 18 18 18 18 18 18 2 2 18 18 18 4 18 18 18 18 18 18 18 18 18 18 18 18 18 18 18 18 18 18 18 18 18 18 18 18 18 4 18 18 18 18 18 18 18 18 18 19 
19 18 18 18 18 18 18 18 2 2 18 18 18 4 18 18 18 18 18 18 18 18 18 18 18 18 18 18 18 18 18 18 18 18 1 18 18 18 18 1 18 18 18 18 18 18 18 18 18 19 
19 18 18 18 18 18 18 18 18 2 18 18 18 4 4 18 18 18 18 18 18 18 18 18 18 2 2 18 18 18 18 18 18 1 1 18 18 18 18 4 18 18 18 18 18 18 18 18 18 19 
19 18 18 18 18 18 18 18 18 2 18 18 18 4 4 1 1 4 4 4 1 1 4 2 4 2 2 18 18 18 18 2 2 2 18 18 18 18 18 2 2 18 18 18 18 18 18 18 18 19 
19 18 18 18 18 18 18 18 4 2 18 18 2 2 4 4 4 2 4 4 4 2 4 4 4 4 18 18 18 18 18 2 2 2 18 18 18 18 18 18 4 18 18 18 18 18 18 18 18 19 
19 18 18 18 18 18 18 18 2 18 18 18 18 2 2 18 18 18 18 18 18 18 18 18 4 4 2 2 2 1 1 2 2 2 18 18 18 18 18 18 4 18 18 18 18 18 18 18 18 19 
19 18 18 18 18 18 18 18 2 18 18 18 18 18 2 18 18 18 18 18 18 18 18 18 1 4 18 18 18 18 1 1 18 18 18 18 18 18 18 18 3 18 18 18 18 18 18 18 18 19 
19 18 18 18 18 18 18 18 4 4 4 2 1 18 18 18 18 18 18 18 18 18 18 18 1 4 18 18 18 18 18 18 18 18 18 18 18 18 18 18 18 18 18 18 18 18 18 18 18 19 
19 18 18 18 18 18 18 18 18 4 1 18 1 2 1 2 2 4 18 18 18 18 18 18 4 2 18 18 18 18 18 18 18 18 18 18 18 18 18 18 18 18 18 18 18 18 18 18 18 19 
19 18 18 18 18 18 18 18 18 1 18 1 2 2 1 22 23 4 23 23 23 23 23 23 4 4 23 23 23 23 23 23 23 24 18 18 18 18 18 18 18 18 18 18 18 18 18 18 18 19 
19 18 18 18 18 18 18 18 18 1 1 2 2 4 18 25 18 1 18 18 18 18 18 18 1 4 18 18 18 18 18 18 18 26 18 18 18 18 18 18 18 18 18 18 18 18 18 18 18 19 
19 18 18 18 18 18 18 18 18 18 18 18 18 18 18 25 18 1 2 1 2 2 18 18 2 2 18 18 18 18 18 18 18 26 2 18 18 18 18 18 18 18 18 18 18 18 18 18 18 19 
19 18 18 18 18 18 18 18 18 18 18 18 18 18 18 27 28 28 28 31 18 1 2 2 2 2 1 1 18 30 28 28 28 29 18 2 2 18 18 18 18 18 18 18 18 18 18 18 18 19 
19 18 18 18 18 18 18 18 18 18 18 18 18 18 18 18 18 18 4 4 1 1 18 18 18 18 18 1 1 4 4 2 2 2 2 2 1 2 2 2 18 18 18 18 18 18 18 18 18 19 
19 18 18 18 18 18 18 4 4 2 4 18 2 18 18 18 18 18 2 25 18 18 18 18 18 18 18 18 18 26 2 2 2 2 2 1 1 2 1 2 18 18 18 18 18 18 18 18 18 19 
19 18 18 18 18 18 18 18 18 2 18 18 18 18 2 1 1 2 2 27 28 28 28 28 28 28 28 28 28 29 18 18 18 2 2 2 2 2 2 2 18 18 18 18 18 18 18 18 18 19 
19 18 18 18 18 18 1 18 18 1 18 18 18 18 2 18 18 18 18 18 18 18 18 18 18 18 18 18 18 18 18 18 18 18 2 2 2 2 1 2 18 18 18 18 18 18 18 18 18 19 
19 18 18 18 18 18 4 2 1 4 2 2 2 4 4 18 18 18 18 18 18 18 18 18 18 18 18 18 18 18 18 18 18 18 1 18 18 18 18 18 18 18 18 18 18 18 18 18 18 19 
19 18 18 18 18 18 1 2 1 1 2 2 4 4 4 18 18 18 18 18 18 18 18 18 18 18 18 18 18 18 18 18 18 18 18 18 18 18 18 18 18 18 18 18 18 18 18 18 18 19 
19 18 18 18 18 18 1 18 1 1 1 1 2 2 2 4 18 18 18 18 18 18 18 18 18 18 18 18 18 18 18 18 18 18 18 18 18 18 18 18 18 18 18 18 18 18 18 18 18 19 
19 18 18 18 18 18 18 18 4 18 18 4 2 2 4 18 18 18 18 18 18 18 18 18 18 18 18 18 18 18 18 18 18 18 18 18 18 18 18 18 18 18 18 18 18 18 18 18 18 19 
19 18 18 18 18 18 18 18 18 18 18 18 18 18 18 18 18 18 18 18 18 18 18 18 18 18 18 18 18 18 18 18 18 18 18 18 18 18 18 18 18 18 18 18 18 18 18 18 18 19 
19 18 18 18 18 18 18 18 18 18 18 18 18 18 18 18 18 18 18 18 18 18 18 18 18 18 18 18 18 18 18 18 18 18 18 18 18 18 18 18 18 18 18 18 18 18 18 18 18 19 
19 19 19 19 19 19 19 19 19 19 19 19 19 19 19 19 19 19 19 19 19 19 19 19 19 19 19 19 19 19 19 19 19 19 19 19 19 19 19 19 19 19 19 19 19 19 19 19 19 19 
