19 19 19 19 19 19 19 19 19 19 19 19 19 19 19 19 19 19 19 19 19 19 19 19 19 19 19 19 19 19 19 19 19 19 19 19 19 19 19 19 19 19 19 19 19 19 19 19 19 19 
19 18 18 18 18 18 18 18 18 18 18 18 18 18 18 18 18 18 18 18 18 18 18 18 18 18 18 18 18 18 18 18 18 18 18 18 18 18 18 18 18 18 18 18 18 18 18 18 18 19 
19 18 18 18 18 18 18 18 18 18 2 18 18 18 18 18 18 18 18 18 18 18 18 18 18 2 2 2 18 18 18 18 18 18 18 18 18 18 18 18 18 18 18 18 18 18 18 18 18 19 
19 18 18 18 18 18 18 18 18 18 18 18 18 18 18 18 18 18 2 18 18 2 18 18 18 18 18 18 18 18 18 18 18 18 18 18 18 18 18 18 2 18 18 2 18 18 18 18 18 19 
19 18 18 18 18 18 18 18 18 2 18 18 18 18 18 18 18 18 18 18 18 18 18 22 23 23 23 23 23 23 23 23 23 23 23 24 18 18 18 18 18 2 18 18 18 2 18 18 18 19 
19 18 18 18 18 18 2 2 18 18 18 18 18 18 18 18 18 18 18 18 18 18 18 25 21 20 20 20 20 20 21 20 21 21 20 26 18 18 18 18 18 18 18 18 2 2 18 18 18 19 
19 18 18 18 18 18 18 18 18 18 18 18 18 18 2 18 18 18 18 18 18 18 18 25 20 30 28 28 28 28 28 28 28 31 20 26 18 18 18 18 18 18 18 2 18 18 18 18 18 19 
19 18 18 18 18 18 18 19 19 19 19 19 19 19 18 18 18 18 18 18 18 18 18 25 20 26 18 18 18 18 18 18 18 25 20 26 18 18 18 18 18 18 18 18 18 18 18 18 18 19 
19 18 18 18 18 18 18 19 17 0 0 35 17 19 18 18 18 18 18 2 2 18 18 25 20 26 18 18 18 18 18 18 18 25 20 26 18 18 18 18 18 18 18 18 18 18 18 18 18 19 
19 18 18 18 18 18 18 19 37 0 0 0 0 19 18 18 18 18 18 18 18 18 22 33 20 26 18 18 2 2 2 18 18 25 21 32 24 18 18 18 18 18 18 18 18 18 18 18 18 19 
19 18 18 18 18 18 18 19 0 0 0 0 0 0 2 2 18 18 18 18 18 18 25 21 20 26 18 18 2 2 2 18 18 25 21 21 26 18 18 18 2 2 18 18 18 18 18 18 18 19 
19 18 18 18 18 18 18 19 0 0 0 0 0 19 2 2 2 18 18 18 18 18 25 20 20 32 23 24 13 11 14 22 23 33 21 21 26 18 18 18 2 1 18 18 18 18 18 18 18 19 
19 18 18 18 18 18 18 19 38 36 0 0 17 19 1 2 1 2 18 18 18 18 25 20 21 20 21 26 9 4 8 25 20 21 21 21 26 18 4 4 1 4 18 18 18 18 18 18 18 19 
19 18 18 18 18 18 18 19 19 19 19 19 19 19 2 18 2 2 2 18 18 18 27 28 28 28 28 29 9 4 8 27 28 28 28 28 29 18 2 18 18 18 18 18 18 18 18 18 18 19 
19 18 18 18 2 18 18 18 18 2 18 18 18 18 2 18 1 2 1 2 18 18 18 18 18 18 18 18 9 4 8 18 18 18 18 18 18 18 1 18 18 18 18 18 18 18 18 18 18 19 
19 18 18 2 18 18 18 18 18 18 18 18 2 18 18 2 18 2 18 1 18 18 18 18 18 18 18 18 9 4 8 18 18 18 18 18 18 18 2 18 18 18 18 18 18 2 18 18 18 19 
19 18 18 18 18 18 22 23 23 24 18 18 18 18 18 18 18 2 1 1 18 18 18 18 18 18 18 18 9 4 8 18 18 18 18 18 1 2 2 18 18 18 18 18 18 18 2 18 18 19 
19 18 18 18 18 18 25 21 21 26 18 18 18 18 18 18 18 18 18 2 18 18 18 18 18 18 18 18 9 4 8 18 18 18 18 18 1 18 18 18 18 18 18 18 18 18 18 18 18 19 
19 18 18 18 18 18 25 21 21 32 24 18 18 18 18 18 2 2 2 2 18 2 18 18 18 18 18 18 9 4 8 18 18 18 18 18 1 18 18 18 18 18 18 18 18 18 18 18 18 19 
19 18 18 18 18 18 25 21 21 21 26 18 18 18 18 18 1 18 1 1 18 18 18 18 18 18 18 18 9 4 8 18 18 18 18 18 1 18 2 18 18 18 18 18 18 18 18 18 18 19 
19 18 18 22 23 23 33 21 30 28 29 18 1 18 4 2 4 2 4 2 4 18 4 2 4 18 18 18 9 4 8 18 18 18 18 18 2 2 2 2 18 18 18 18 2 18 18 18 18 19 
19 18 18 25 21 30 28 28 29 18 18 18 2 4 4 2 4 4 4 2 4 4 4 2 2 18 18 18 15 6 16 18 18 18 18 2 18 2 2 2 18 18 18 18 2 18 18 18 18 19 
19 18 18 25 21 26 18 18 18 18 18 18 2 2 18 18 18 18 18 18 18 18 18 2 2 4 2 2 4 2 4 4 18 18 18 2 2 2 2 2 18 18 18 2 18 18 18 18 18 19 
19 18 18 25 21 26 18 18 18 18 18 18 4 2 18 18 18 18 18 18 18 18 18 18 4 2 2 4 4 4 4 2 4 4 2 2 2 2 1 1 18 18 2 18 18 18 18 18 18 19 
19 18 18 25 21 26 18 18 18 18 18 18 18 2 18 18 18 18 18 18 18 18 18 18 18 18 18 18 1 18 18 18 18 18 18 18 18 18 18 1 18 18 18 18 18 18 18 18 18 19 
19 18 22 33 21 26 18 18 18 18 18 18 18 2 18 18 18 18 18 18 18 18 18 18 18 18 18 18 18 18 18 18 18 18 18 18 18 18 18 1 18 18 18 18 18 18 18 18 18 19 
19 18 25 21 21 26 18 18 4 18 18 18 18 4 18 18 18 18 18 18 18 18 18 18 18 18 18 18 18 18 18 18 18 18 18 18 18 18 18 4 18 18 18 18 18 18 18 18 18 19 
19 18 25 21 21 26 18 18 2 2 18 18 18 4 18 18 18 18 18 18 18 18 18 18 18 18 18 18 18 18 18 18 18 18 1 18 18 18 18 1 18 18 18 18 18 22 23 24 18 19 
19 18 27 31 21 26 18 18 18 4 18 18 18 2 4 18 18 18 18 18 18 18 18 18 18 18 18 18 18 18 18 18 18 1 1 18 18 18 18 4 18 18 18 18 22 33 21 26 18 19 
19 18 18 27 31 26 18 18 2 2 18 18 18 4 2 2 2 4 4 2 2 2 4 2 2 2 18 18 18 18 18 2 2 2 18 18 18 18 18 2 2 18 18 22 33 21 20 26 18 19 
19 18 18 18 25 32 24 18 4 2 18 18 18 2 4 2 4 2 4 4 4 2 4 2 4 2 2 18 18 18 2 2 2 2 18 18 18 18 18 18 4 18 18 25 20 20 20 26 18 19 
19 18 18 18 25 21 26 18 2 18 18 18 18 18 18 18 18 18 18 18 18 18 18 18 4 4 2 2 2 1 1 2 2 2 18 18 18 18 18 18 4 18 18 25 21 21 21 26 18 19 
19 18 18 18 27 28 29 18 4 18 18 18 18 18 18 18 18 18 18 18 18 18 18 18 1 4 18 18 18 18 1 1 18 18 18 18 18 18 18 18 18 18 18 25 20 21 20 26 18 19 
19 18 18 18 18 18 18 18 2 4 2 2 4 2 2 2 2 4 4 2 18 18 18 18 2 2 18 18 18 18 18 18 18 18 18 18 18 18 18 18 18 18 18 25 21 20 21 26 18 19 
19 18 18 18 18 18 18 18 18 2 1 4 18 2 22 23 23 23 24 2 22 23 23 24 2 2 22 23 23 23 23 23 23 24 18 18 2 2 18 18 18 18 18 25 21 21 21 26 18 19 
19 18 18 18 2 18 18 18 18 1 18 2 18 4 25 20 30 28 29 2 27 28 28 29 2 2 27 28 28 28 28 28 31 26 18 18 18 18 18 18 18 18 18 27 31 21 20 26 18 19 
19 18 18 18 18 18 18 18 18 4 4 2 2 4 25 21 26 18 18 2 2 2 2 2 1 4 18 18 18 18 18 18 25 26 18 18 18 18 18 18 18 4 18 18 25 21 20 26 18 19 
19 18 18 18 18 18 18 2 18 18 18 18 18 18 25 20 26 18 18 18 18 18 18 18 2 2 18 18 18 18 18 18 25 26 2 18 18 18 18 18 18 4 18 18 27 31 30 29 18 19 
19 18 18 18 18 18 18 18 18 18 18 18 18 18 25 21 32 23 23 23 24 18 18 18 2 2 18 18 22 23 23 23 33 26 18 2 2 18 18 18 4 4 18 18 18 27 29 18 18 19 
19 18 18 18 18 18 18 18 18 4 2 18 18 18 27 28 28 28 28 28 29 18 18 18 2 2 18 18 27 28 28 28 28 29 2 18 4 2 2 4 4 18 18 18 18 18 18 18 18 19 
19 18 18 18 18 2 18 18 18 2 4 2 18 18 18 18 18 2 4 2 2 2 2 2 2 2 2 2 2 2 4 2 2 2 2 18 18 4 18 2 2 18 18 18 18 18 18 18 18 19 
19 18 18 18 18 2 18 18 18 2 4 2 2 1 2 2 2 4 2 18 18 18 18 18 18 18 18 18 2 2 18 18 18 2 2 2 4 18 2 4 18 18 18 18 18 18 18 18 18 19 
19 18 18 18 18 18 18 18 18 2 2 1 2 2 2 18 18 18 18 22 24 18 18 18 18 18 18 18 22 24 2 18 18 18 4 2 2 2 2 2 18 18 18 2 2 18 18 18 18 19 
19 18 18 18 18 18 2 18 18 18 18 18 4 4 18 18 18 18 18 25 32 23 23 23 23 23 23 23 33 26 2 18 18 18 1 18 2 2 18 18 18 18 18 18 2 18 18 18 18 19 
19 18 18 18 2 18 18 18 18 18 18 18 18 18 18 18 18 18 18 27 28 28 28 28 28 28 28 28 28 29 18 18 18 18 18 18 18 18 18 18 18 18 18 18 18 18 18 18 18 19 
19 18 18 18 18 18 18 18 18 18 18 18 18 18 18 18 18 18 18 18 18 18 18 18 18 18 18 18 18 18 18 18 18 18 18 18 18 18 18 18 18 18 18 18 18 18 18 18 18 19 
19 18 18 18 18 18 2 18 18 18 18 2 2 18 18 18 18 18 18 18 18 18 18 18 18 18 18 18 18 18 18 18 18 18 2 18 18 18 18 18 18 18 18 18 18 18 18 18 18 19 
19 18 18 18 18 18 18 18 18 18 18 18 18 18 18 18 18 18 18 18 18 18 18 18 18 18 18 18 18 18 18 18 18 18 18 18 18 18 18 18 18 18 18 18 18 18 18 18 18 19 
19 18 18 18 18 18 18 18 18 18 18 18 18 18 18 18 18 18 18 18 18 18 18 18 18 18 18 18 18 18 18 18 18 18 18 18 18 18 18 18 18 18 18 18 18 18 18 18 18 19 
19 19 19 19 19 19 19 19 19 19 19 19 19 19 19 19 19 19 19 19 19 19 19 19 19 19 19 19 19 19 19 19 19 19 19 19 19 19 19 19 19 19 19 19 19 19 19 19 19 19 
